0000000000000000000000000000000000000000
0000000000000000000000000000000000000000
1100000000000000000111100000000000000000
1100000000000000000000000000000000000000
1100000000000111100000000000000000000000
1100000000000000000000000000000000000000
1100000000000000000000000000000000000000
1111111111111111111111111111111111111111
2222222222222222222222222222222222222222
2222222222222222222222222222222222222222